011111111111111111111111111111
011111111111111111111111111111
011111111111111111111111111111
011111111111111111111111111111
011111111111111111111111111111
011111111111111111111111111111
011111111111111111111111111111
011111111111111111111111111111
011111111111111111111111111111
011111111111111111111111111111
011111111000000000111111111111
011111111111111111111111111111
011111111111111111111111111111
011111111111111111111111111111
011111100000000000000000011111
011111111111111111111111111111
011111111111111111111111111111
011110000000000000000000001111
011111111111111111111111111111
011111111111111111111111111111
011111111111111111111111111111
011111111111111111111111111111
011111111111111111111111111111
011111111111111111111111111111
011111111111111111111111111111
011111111111111111111111111111
011111111111111111111111111111
011111111111111111111111111111
011111111111111111111111111111
011111111111111111111111111111


